
NO ./sprite/forest.xpm
SO ./sprite/forest.xpm
WE ./sprite/forest.xpm
EA ./sprite/forest.xpm
 
F 34,125,70
C 135,206,235

11111111111111111111111111111111111111111111111111111111111
1000066666BB00000000000000000000000000000000000000000000001
100006c3330000000000000000000000000000000000000000000000001
10000633360000000000000000000000000000000000000000000000001
16636633360000000000000000000000000000000000000000000000001
16c33333360000000000000000000000000000000000000000000000001
16666666660000000000000000000000000000000000000000000000001
10000000000000000000000000000000000000000000000000000000001
10000B00000000000000000000000000000000000000000000000000001
10000000000000000000000000000000000000000000000000000000001
1000000000000000000p000000000000000000000000000000000000001
10000000000000p00000000000000000222222220000000000000000001
10000000000000000000000000E00000533333320000000000000000001
10000000000000000000000000000000223333320000000000000000001
10000000000000000000000000000000022222220000000000000000001
10000B00000000000000000000000000000000000000000000000000001
10000000000000000000000000000000000000000000000000000000001
10000000000000000000000000000000000000000000000000000000001
10000000000000000000000000000000000000000000000000000000001
10000000000000000000000000000000000000000000000000000000001
10000000000000000000000000000000000000000000000000000000001
10000000000000000000000000000000000000000000000000000000001
10000000000000000000000000000000000000000000000000000000001
10000000000000000000000000000000000000000000000000000000001
10000000000000000000000000000000000000000000000000000000001
10000000000000000000000000000000000000000000000000000000001
10000000000000000000000000000000000000000000000000000000001
11111111111111111111111111111111111111111111111111111111111
