
NO ./ex.cub
SO ./ex.cub
WE ./ex.cub
EA ./ex.cub
 
F 0,153,0
C 102,102,255

11111111
10N10011
10000001
10010011
11111111
