
NO ./sprite/forest.xpm
SO ./sprite/forest.xpm
WE ./sprite/forest.xpm
EA ./sprite/forest.xpm
 
F 34,125,70
C 135,206,235

11111111111111111111111111111111111111111111111111111111111
10000CCCCCB000000000000000000000000000000000000000000000001
10000C33330000000000000000000000000000000000000000000000001
10000C3c3C0000000000000000000000000000000000000000000000001
1CC3CC333C0000000000000000000000000000000000000000000000001
1C333333cC0000000000000000000000000000000000000000000000001
1CCCCCCCCC0000000000000000000000000000000000000000000000001
10000000000000000000000000000000000000000000000000000000001
10000B00000000000000000000000000000000000000000000000000001
10000B000000000000c000000000000000B000000000000000000000001
1000000000000000000000000000E00B0p0000000000000000000000001
1000000000000000000000000000000cMMmMmMMM0000000000000000001
10000000000000000000000000000000D222222m0000000000000000001
10000000000000000000000000000000MM22222M0000000000000000001
100000000000000000000000000000000MMmMmMM0000000000000000001
10000000000000000000000000000000000000000000000000000000001
10000000000000000000000000000000000000000000000000000000001
10000000000000000000000000000000000000000000000000000000001
10000000000000000000000000000000000000000000000000000000001
10000000000000000000000000000000000000000000000000000000001
10000000000000000000000000000000000000000000000000000000001
10000000000000000000000000000000000000000000000000000000001
10000000000000000000000000000000000000000000000000000000001
10000000000000000000000000000000000000000000000000000000001
10000000000000000000000000000000000000000000000000000000001
10000000000000000000000000000000000000000000000000000000001
10000000000000000000000000000000000000000000000000000000001
11111111111111111111111111111111111111111111111111111111111
