
NO ./sprite/forest.xpm
SO ./sprite/forest.xpm
WE ./sprite/forest.xpm
EA ./sprite/forest.xpm
 
F 34,125,70
C 135,206,235

11111111111111111111111111111111111111111111111111111111111
10000666660000000000000000000000000000000000000000000000001
100S0633330000000000000000000000000000000000000000000000001
10000633360000000000000000000000000000000000000000000000001
16636633360000000000000000000000000000000000000000000000001
16333333360000000000000000000000000000000000000000000000001
16666666660000000000000000000000000000000000000000000000001
10000000000000000000000000000000000000000000000000000000001
10000000000000000000000000000000000000000000000000000000001
10000000000000000000000000000000000000000000000000000000001
10000000000000000000000000000000000000000000000000000000001
10000000000000000000000000000000024224220000000000000000001
10000000000000000000000000000000053333340000000000000000001
10000000000000000000000000000000023333320000000000000000001
10000000000000000000000000000000022424220000000000000000001
10000000000000000000000000000000000000000000000000000000001
10000000000000000000000000000000000000000000000000000000001
10000000000000000000000000000000000000000000000000000000001
10000000000000000000000000000000000000000000000000000000001
10000000000000000000000000000000000000000000000000000000001
10000000000000000000000000000000000000000000000000000000001
10000000000000000000000000000000000000000000000000000000001
10000000000000000000000000000000000000000000000000000000001
10000000000000000000000000000000000000000000000000000000001
10000000000000000000000000000000000000000000000000000000001
10000000000000000000000000000000000000000000000000000000001
10000000000000000000000000000000000000000000000000000000001
11111111111111111111111111111111111111111111111111111111111
