
NO ./sprite/forest.xpm
SO ./sprite/forest.xpm
WE ./sprite/forest.xpm
EA ./sprite/forest.xpm
 
F 86,125,70
C 135,206,235

11111111111
10000000001
10010011001
1000N000001
10000000001
11111111111