
NO ./ex.cub
SO ./ex.cub
WE ./ex.cub
EA ./ex.cub
 
F 220,100,250
C 225,30,0

111111111
1010N0001
101000001
101000001
111111111
