NO ./sprite/forest.xpm
SO ./sprite/forest.xpm
WE ./sprite/forest.xpm
EA ./sprite/forest.xpm
 
F 34,125,70
C 135,206,235

11111111111111111111111111111111111111111111111111
10000CCCCCCCCCCCCCCCCCCCCCCc0000000000000000000c01
10S00C33b333333b3333C3333bC00000000000000000000001
10000C3c3C3C33CC3CC333C3C3C00000000000000000000001
1CC3CC333C3C333C33CCCCC3C3C000b0000000000000000001
1C333333cC3C3CCC33CB0033C3C00000000000000000000001
1CCCCCCCCC3C3C033CCB0BC3C3C3C000000000000000000001
1C333c3C333C333CCCB00BC3C333C00000000b000000000001
1C3C3b333C3b3CCCcCCCCCC3C3CCC000000000000000000001
1C3CC3333C3CCCCc333333333bcCc000000000000000000001
1C3CCCCCCC3333CCCCCCCCCCCCCC000B000000000000000001
1C3CCc33cC3CC33C00000BBB00000000MMmMmMMM0000000001
1C333b3C333CB0000000000000000000D222p22m000000b001
1CCCCCCCCCCCB00000b0000000000000MMc2222M0000000001
1B0000000000000000b00000000000000MMmMmMM0000000001
1B000c00000000000000000000000000000000000000000001
1CCCCCCCCCCCCCCCCCCCCCCCCCCCC000000000000000000001
1CB3333333333333333333333333C000000b00000000000001
1CB333333333333333333333b3333000000000000000000001
1CCCCCCCCCC33CCB3333333b33333000000000000000000001
1C33333333b33CCCB33333333333C000000000000000000001
1C333p333333b3cCc33333333333C000000000000000000001
1CCCCCCCCCCCCCCCCCCCCCCCCCCCCc00000000000000000001
11111111111111111111111111111111111111111111111111
