
NO ./ex.cub
SO ./ex.cub
WE ./ex.cub
EA ./ex.cub
 
F 220,100,250
C 225,30,0

111111111
1010N1001
101010001
101010001
111111111
