
NO ./ex.cub
SO ./ex.cub
WE ./ex.cub
EA ./ex.cub
 
F 220,100,250
C 225,30,0

1111111111
1001000101
10N1010101
1000010001
1111111111
