
NO ./sprite/forest.xpm
SO ./sprite/forest.xpm
WE ./sprite/forest.xpm
EA ./sprite/forest.xpm
 
F 86,125,70
C 135,206,235

11111111
1N010011
10000001
10010011
11111111
