
NO ./ex.cub
SO ./ex.cub
WE ./ex.cub
EA ./ex.cub
 
F 220,100,250
C 225,30,0

  111111111
  1010N10011
  101000N001
  1010010011
11111111111
