
NO ./sprite/forest.xpm
SO ./sprite/forest.xpm
WE ./sprite/forest.xpm
EA ./sprite/forest.xpm
 
F 34,125,70
C 135,206,235

111111111111111111
100000000000000001
105555555000000001
105666666000000001
10566N665000000001
105555555000000001
111111111111111111
