
NO ./sprite/forest.xpm
SO ./sprite/forest.xpm
WE ./sprite/forest.xpm
EA ./sprite/forest.xpm
 
F 34,125,70
C 135,206,235

11111111111111111111111111111111111111111111111111111111111
10000CCCCCCCCCCCCCCCCCCCCCC00000000000000000000000000000001
10S00C33333333333333C33333C00000000000000000000000000000001
10000C3c3C3C33CC3CC333C3C3C00000000000000000000000000000001
1CC3CC333C3C333C33CCCCC3C3C00000000000000000000000000000001
1C333333cC3C3CCC33C00033C3C00000000000000000000000000000001
1CCCCCCCCC3C3C033CC000C3C3C3C000000000000000000000000000001
1C333c3C333C333CCC0000C3C333C000000000000000000000000000001
1C3C33333C333CCC3CCCCCC3C3CCC000000000000000000000000000001
1C3CC3333C3CCCCc333C333333cC000p000000000000000000000000001
1C3CCCCCCC3333CCCCCCCCCCCCCC000B000000000000000000000000001
1C3CC3333C3CC33C000000000000000cMMmMmMMM0000000000000000001
1C33333C333C00000000000000000000D222222m0000000000000000001
1CCCCCCCCCCC00000000000000000000MM22222M0000000000000000001
100000000000000000000000000000000MMmMmMM0000000000000000001
10000000000000000000000000000000000000000000000000000000001
10000000000000000000000000000000000000000000000000000000001
10000000000000000000000000000000000000000000000000000000001
10000000000000000000000000000000000000000000000000000000001
10000000000000000000000000000000000000000000000000000000001
10000000000000000000000000000000000000000000000000000000001
10000000000000000000000000000000000000000000000000000000001
10000000000000000000000000000000000000000000000000000000001
10000000000000000000000000000000000000000000000000000000001
10000000000000000000000000000000000000000000000000000000001
10000000000000000000000000000000000000000000000000000000001
10000000000000000000000000000000000000000000000000000000001
11111111111111111111111111111111111111111111111111111111111
